20 15
19 70
10
0 2 16 2 16 4 2 4 2 7 4 7 4 11 16 11 16 9 19 9
3 3 3 3 3 3 3 3 3 3 3 3 3 3 3 3 2 2 2 2
0 0 0 0 0 0 0 0 0 0 0 0 0 0 0 0 0 0 2 2
1 1 1 1 1 1 1 1 1 1 1 1 1 1 1 1 1 0 0 0
2 2 0 0 0 0 0 0 0 0 0 0 0 0 0 0 1 0 0 0
0 0 1 1 1 1 1 1 1 1 1 1 1 1 1 1 1 0 0 0
0 0 1 0 0 0 0 0 0 0 0 0 0 0 0 0 0 0 0 0
0 0 1 2 2 0 0 0 0 0 0 0 0 0 0 0 0 2 2 2
0 0 1 1 1 0 4 4 4 4 0 0 0 0 0 0 0 2 2 2
0 0 0 0 1 0 0 0 1 0 0 0 0 0 0 0 0 0 2 2
0 0 0 0 1 0 0 0 1 0 0 0 0 0 0 0 1 1 1 1
0 0 0 0 1 0 0 0 0 0 0 0 0 0 0 2 1 0 0 0
0 0 0 0 1 1 1 1 1 1 1 1 1 1 1 1 1 0 0 0
2 0 0 0 0 0 0 0 0 0 0 0 0 0 0 0 0 0 2 2
2 2 2 2 2 0 0 0 0 0 0 0 0 0 0 0 0 0 2 2
2 2 2 2 2 2 0 0 0 0 0 0 0 0 0 2 2 2 2 2
